  2 2 ..44
 4.........6
 ....4...5.
 .....5....
 ..........
 ..........
2...4......
6.....56...
   2    ..6